........................................
........................................
........................................
........................................
..###########..###########..###########.
..#.................#............#......
..#.................#............#......
..#.................#............#......
..########..........#............#......
..#.................#............#......
..#.................#............#......
..#.................#............#......
..#............###########.......#......
........................................
........................................
........................................
###########..###########..###########...
#.................#............#........
#.................#............#........
#.................#............#........
########..........#............#........
#.................#............#........
#.................#............#........
#.................#............#........
#............###########.......#........
........................................
........................................
........................................
...###########..###########..###########
...#.................#............#.....
...#.................#............#.....
...#.................#............#.....
...########..........#............#.....
...#.................#............#.....
...#.................#............#.....
...#.................#............#.....
...#............###########.......#.....
........................................
........................................
........................................